00 00 00 00 00 00 00 00 00 00 00 00 00 00 03 01 01 01 01 01 01 01 01 01 01 04 00 00 00 00 00 00 00 00 00 00 00 00 00 00
00 00 00 00 00 00 00 00 00 00 00 00 00 00 02 08 08 08 08 08 08 08 08 08 08 02 00 00 00 00 00 00 00 00 00 00 00 00 00 00
00 00 00 00 00 00 00 00 00 00 00 00 00 00 02 08 08 08 08 08 08 08 08 08 08 02 00 00 00 00 00 00 00 00 00 00 00 00 00 00
00 00 00 00 00 00 00 00 00 00 00 00 00 00 02 08 08 08 08 08 08 08 08 08 08 02 00 00 00 00 00 00 00 00 00 00 00 00 00 00
00 00 00 00 00 00 00 00 00 00 00 00 00 00 06 04 09 09 09 03 04 09 09 09 03 05 00 00 00 00 00 00 00 00 00 00 00 00 00 00
00 00 00 00 00 00 00 00 00 00 00 00 00 00 00 02 09 09 09 02 02 09 09 09 02 00 00 00 00 00 00 00 00 00 00 00 00 00 00 00
00 00 00 00 00 00 00 00 00 00 00 00 00 00 00 02 09 09 09 02 02 09 09 09 02 00 00 00 00 00 00 00 00 00 00 00 00 00 00 00
00 00 00 00 00 00 00 00 00 00 00 00 00 00 00 02 09 09 09 02 02 09 09 09 02 00 00 00 00 00 00 00 00 00 00 00 00 00 00 00
00 00 00 00 00 00 00 00 00 00 00 00 00 00 00 02 09 09 09 02 02 09 09 09 02 00 00 00 00 00 00 00 00 00 00 00 00 00 00 00
00 00 00 00 00 00 00 03 01 01 01 01 04 00 00 07 09 09 09 06 05 09 09 09 08 00 00 03 01 01 01 01 04 00 00 00 00 00 00 00
00 00 00 00 00 00 00 02 10 10 10 10 02 00 07 09 09 09 09 09 09 09 09 09 09 08 00 02 10 10 10 10 02 00 00 00 00 00 00 00
00 00 00 00 00 00 03 05 10 10 10 10 06 07 09 09 09 09 09 09 09 09 09 09 09 09 08 05 10 10 10 10 06 04 00 00 00 00 00 00
00 00 00 00 00 00 02 09 09 09 09 09 09 09 09 09 09 09 09 09 09 09 09 09 09 09 09 09 09 09 09 09 09 02 00 00 00 00 00 00
00 00 00 00 00 00 02 09 09 09 09 09 09 09 09 09 09 09 09 09 09 09 09 09 09 09 09 09 09 09 09 09 09 02 00 00 00 00 00 00
00 00 00 00 00 00 02 09 09 09 09 09 09 09 09 09 09 09 09 09 09 09 09 09 09 09 09 09 09 09 09 09 09 02 00 00 00 00 00 00
00 00 00 00 00 00 02 09 09 09 03 01 01 01 01 01 01 01 01 01 01 01 01 01 01 01 01 01 01 04 09 09 09 02 00 00 00 00 00 00
00 00 00 00 00 00 02 09 09 09 02 00 00 02 09 09 09 09 09 09 09 09 09 09 09 09 02 00 00 02 09 09 09 02 00 00 00 00 00 00
00 00 00 00 00 00 02 09 09 09 02 00 00 02 09 09 09 09 09 09 09 09 09 09 09 09 02 00 00 02 09 09 09 02 00 00 00 00 00 00
00 00 00 00 00 00 07 09 09 09 02 00 00 02 09 09 09 09 09 09 09 09 09 09 09 09 02 00 00 02 09 09 09 08 00 00 00 00 00 00
00 00 00 00 00 07 09 09 09 09 02 00 00 06 01 01 01 01 01 01 01 01 01 01 01 01 05 00 00 02 09 09 09 09 08 00 00 00 00 00
00 03 01 01 07 09 09 09 09 09 02 00 00 00 00 00 00 03 01 01 01 01 04 00 00 00 00 00 00 02 09 09 09 09 09 08 01 01 04 00
00 02 10 10 10 09 09 09 09 09 02 00 00 00 00 00 00 02 10 10 10 10 02 00 00 00 00 00 00 02 09 09 09 09 09 10 10 10 02 00
00 02 10 10 10 09 09 09 09 07 05 03 01 01 01 01 01 05 10 10 10 10 06 01 01 01 01 01 04 00 08 09 09 09 09 10 10 10 02 00
00 02 09 09 09 09 09 09 07 00 00 02 09 09 09 09 09 09 09 09 09 09 09 09 09 09 09 09 02 00 00 08 09 09 09 09 09 09 02 00
00 02 09 09 09 09 09 07 00 00 00 02 09 09 09 09 09 09 09 09 09 09 09 09 09 09 09 09 02 00 00 00 08 09 09 09 09 09 02 00
00 02 09 09 09 09 07 00 00 00 00 02 09 09 03 01 01 01 01 01 01 01 01 01 01 04 09 09 02 00 00 00 00 08 09 09 09 09 02 00
00 02 09 09 09 07 00 00 00 00 00 02 09 09 02 00 00 00 00 00 00 00 00 00 00 02 09 09 02 00 00 00 00 00 08 09 09 09 02 00
00 02 09 09 09 02 00 00 00 00 00 02 09 09 02 00 00 00 00 00 00 00 00 00 00 02 09 09 02 00 00 00 00 00 02 09 09 09 02 00
00 02 09 09 09 02 00 00 00 00 00 02 09 09 06 01 01 01 01 01 01 01 01 01 01 05 09 09 06 01 01 01 01 01 05 09 09 09 02 00
00 02 09 09 09 02 00 00 00 00 00 02 09 09 09 09 09 09 09 09 09 09 09 09 09 09 09 09 09 09 09 09 09 09 09 09 09 09 02 00
00 02 09 09 09 02 00 00 00 00 00 02 09 09 09 09 09 09 09 09 09 09 09 09 09 09 09 09 09 09 09 09 09 09 09 09 09 09 02 00
00 02 09 09 09 02 00 00 00 00 00 02 09 09 03 01 01 01 01 01 01 01 01 01 01 04 09 09 03 01 01 01 01 01 04 09 09 09 02 00
00 02 09 09 09 02 00 00 00 00 00 02 09 09 02 00 00 00 00 00 00 00 00 00 00 02 09 09 02 00 00 00 00 00 02 09 09 09 02 00
00 02 09 09 09 02 00 10 10 10 00 02 09 09 02 00 00 00 00 00 00 00 00 00 00 02 09 09 02 00 10 10 10 00 02 09 09 09 02 00
00 02 09 09 09 06 01 10 10 10 01 05 09 09 06 01 01 01 01 01 01 01 01 01 01 05 09 09 06 01 10 10 10 01 05 09 09 09 02 00
00 02 09 09 09 09 09 09 09 09 09 09 09 09 09 09 09 09 09 09 09 09 09 09 09 09 09 09 09 09 09 09 09 09 09 09 09 09 02 00
00 02 09 09 09 09 09 09 09 09 09 09 09 09 09 09 09 09 09 09 09 09 09 09 09 09 09 09 09 09 09 09 09 09 09 09 09 09 02 00
00 02 09 09 09 09 09 09 09 09 09 09 09 09 09 09 09 09 09 09 09 09 09 09 09 09 09 09 09 09 09 09 09 09 09 09 09 09 02 00
00 06 01 01 01 01 01 01 01 01 01 01 01 01 01 01 01 04 10 10 10 10 03 01 01 01 01 01 01 01 01 01 01 01 01 01 01 01 05 00
00 00 00 00 00 00 00 00 00 00 00 00 00 00 00 00 00 02 10 10 10 10 02 00 00 00 00 00 00 00 00 00 00 00 00 00 00 00 00 00